####################
#     #       #    #
#  @  # /     #    #
#  ## ###  ## #  @ #
#  !      !   #    #
#  ###### ###@###  #
#  #   @  @  !  @  #
#  #  ##  #  @  #  #
#  #  ##  #######  #
#  #     !    @  # #
#  ### ######  ##@ #
#    #  @@  #  ##  #
#  ###  #### #  ## #
#  #      !  @  !  #
#  #  #######  # # #
#     #     #  @   #
# !#  #  @  #  ###@#
#  #  ###   #  #D# #
#  #     @   @   ! #
####################