####################
#     #   #        #
#  @  # #   #  ##  #
#  ## #@#####@#    #
#  !#   #  @#  # # #
#  ######@####@#   #
# ##   #   # # @## #
#!!# #   # @ !#  #!#
## # ###@@#  #  @#@#
#  #     !    ##!  #
#  ###### ### #   ##
#    #   @  #  #  ##
####@#@###  #  ##  #
#  # #  # !  @#  ! #
#@@#  !  ### ## @###
# ###  # #@###  !  #
#     #  @ !  ##@#@#
#  # #######@#     #
# /#         # # !D#
####################