####################
#    !#   #     #  #
#  @  # #   #  @#  #
#  ## # ##@## #  ! #
#  !#   #     #  # #
#  ######  ###@#   #
# ##    @    # @## #
#  #  #   # !#   # #
#  #  ###  #  # @  #
#  #  !   ### #  # #
#  ###### #   #  # #
# !  #      ## #!  #
#### # #### ## ##@ #
#  # #  # !  @#   ##
#@ #   #  # ## @   #
# ###@ # #@###     #
#      #  #    ### #
#   # ##### @ # #D##
# /#   #   @  !   @#
####################