####################
#     #       #    #
#  @  #/      #    #
#  ## ###  ## #    #
#  !      @   #    #
#  ###### ###@###  #
#  #      @     @  #
#  #  ##  #  !  #  #
#  #  ##  ###@### @#
#  #     !       # #
#  ### ######  ##  #
#    #   @  #  ##  #
#  ###  #### #@ ## #
#  #      !  @  !  #
#  #  #######  # # #
#     #     #      #
# !#  #  @  #  ###@#
#  #  ###   #  #D# #
#  #         @   ! #
####################