####################
#     #       #    #
#  @  # /     #    #
#  ## ###  ## #  ! #
#  !      @   #    #
#  ###### ###@###  #
#  #      @     @  #
#  #  ##  #  @  #  #
#  #  ##  #######  #
#  #     !       # #
#  ### ######  ##  #
#    #   @  #  ##  #
#  ###  #### #  ## #
#  #      !  @     #
#  #  ##### #  # # #
#     #     #      #
# !#  #  @  #  ### #
#  #  ###   #  #D# #
#  #         @     #
####################